type octile
height 7
width 6
map
@....@
@..@.@
@.@.@@
@.@@@@
@..@.@
@.@@.@
@....@